1111111111
1000000001
100000001
1000000001
1111111111
