111111111111111111111111111111111111111111111111111111111111
101000001111101011111110111010001111011111110001111110000001
101P1110000C101010000010101010101001000000010101000010111101
101110001111101010111010101010101101011111010101011110100101
100000001000001010100010101010100101010001010101010000111101
101111101011101110101110101010110101010101110101011110000001
1000000010C1000000101000001010100000000101000101010001111101
100011111111011110101111111010111110010101011101011101000101
101010000000010000101000000010100010010101010001010101011101
101010111111110111101011111110101011110101010111010101010001
101010100000000100001010000000101010000101010100010101011101
101010101111111101111010111111101010111101010101110101010101
101010101000000001000010100000001010100001010100000101010101
101010101011111111011110101111111010101111010111111101010001
101010101010000000010000101000000010101000010100000001010101
101010101010111110110111101011111110101C11110111111110010101
101010101010100010100100001010000000101000000101000000010101
101010101010101010101101111010111111101011111101011111110101
101010101010101010101000000010100000001010000001010000000101
101010101010101010101011111110101C1111101011111101011111C101
101010101010101010101010000000101000000010100000010000000101
101010101010101010101010111111101111111010111111111111111101
101010101010101010101010000000001000000000000000000000000101
101010101010101010101010111111110111111110011111111111101101
101010101010101010101010100000001000000000010100000000000001
101010101010101010101010111111111011111111010101111111111101
101000101010001010001010000000000010000000010100000000000101
101011101011101011111011111111111110111111110101111111111101
1C10C10000000010000C10000000000000100000000100000000000C1E01
111111111111111111111111111111111111111111111111111111111111
