1111111111
1000000001
1000000001
1000000001
111z111111
