111111111111111111111111111111
10P000100100000010000000000001
10C0C0100000000000000000000001
10C0C0100100000010000000000001
10C0C0100100000010000000000001
10C0C0100100000010000000000001
10C0C0100000000010000000000001
10C0C0100100000011000000000001
100000E0010000001C000000001001
111111111111111111111111111111
