111111111111111111111111111111
10P000100100000010000000000001
10C0C0100000000000000000000001
10C0C0100100000010000000000001
10C0C0100100000010000000000001
10C0C0100100000010000000000001
10C0C0100000000010000000000001
10C0C0100100000010000000000001
100000E00100000010000000001001
111111111111111111111111111111
